%%%%%%%%%%%%%%%
%......%%....%%
%   %%%%%%%  %%
% G    G  o  P%
%             %
% G G         %
%%%%%%%%%%%%%%%
% % % % %%%%%%%
%%%%%%%%%%%%%%%